I X I X X X I I I I I I I I I I
I X I X X X I I I I I I I I I I
I X I X X X I E X X X X X X X I
I X I X X X I I I I I I C I I I
I X I W W W I I I I I I C I I I
I X I X X X I X X X X X X X X I
I X I X X X I I I I I I X I I I
I X R X X X X X X X X X X X X I
I I I I I I I I I I I I I I I I
%
EGF(1,0)
G(1,3)
G(1,4)
VS(1,6)
EGF(1,7)
RF(4,6)
F(5,7)
EGF(14,2)
%
1,1
