I I I I I I I C C C I W W W I I
I I I I X X I C C C I I W W I I
I I X I X X I X X X X X W X X I
I I X I X X I X I X I I W W X I
I I X X X I I X I X X W W W E I
I I I X I I I X I I X W W W I I
I I I X I I I X I I X I W I I I
I X X X X X X X X X X W W W I I
I I I I I I I X I I I W W W I I
%
MV(4,1)
GS(10,6)
GS(2,2)
%
7,8
