X X I X X I W W C C R R X X X X
I X I M M I I I C C C C C C C C
W X W W W W W R R R R R I I I I
X X X X X X X X X X X X I I X X
X X X X X X X X X X X X I I X X
X X X X X X X X X E X X I I X X
X X M M M X X X X X X X I I X X
X X X X X X X X X X X X I I X X
I I I I I I I I I I I I I I I I
%
POF(1,0)
POM(1,8)
POL(15,8)
POP(5,5)
F(1,1)
%
1,1
